1111111111111111111111111111111111111
1000010000001000001000001000000000001
1011010111010111010111010111111111011
10000100000100000100P0010001000000001
1011111111011111110111111111011111111
1000000000000000000000000000010000001
1111011111111111111111111111010111011
1000010000000C00000000000000010000001
1011111111111111111111111111111111111
10000000000000000000E0000000000000001
1111111111111111111111111111111111111